R 848 480

NO ./img/wood.xpm

SO ./img/eagle.xpm

WE ./img/greystone.xpm

EA ./img/redbrick.xpm

S  ./img/sprite.xpm

F 184,113,39

C 51,198,227

11111111111111111111111111111
10000000001100000000010000001
111110000111000000000000100011
1   111001010000000000000000011111
111110000111000000000000100011
   1000000000110000011101111011
111101111111110111000000100011
11110111111111011101010010001
11000000110101011100000010001
10000000000000001100000010001
10000200W00000001100010000001
11000001010101000000000000001
11110111110101000000000000001
10000000001100000100000010001
10000000000000000000000001001
10000000001000010000000001001
10000000001101000000000000001
10000000000100000001010000001
11111111111111111111111111111
