

F  200,200,80
S  ./img/sprite.xpm

SO ./text/wolf/eagle.xpm

R    1000 600
NO     ./text/wolf/redbrick.xpm
WE   ./text/wolf/bluestone.xpm
EA  ./text/wolf/wood.xpm

C 0,255,255


            1111111111111111
            1000001000000001
            1000001000000001
            100000100000000111111111
            100000100000000100000201
111111111111100011111110000100000201
100000000000000020002002000000000201
10000000000000000000200200E000000201
100000000000100000002000000000000201
111111111000111111111100011111111111
1000000000001        100000000100001
1000000000001        100000000000001
100011111111111111111111110000111111
1000100000000000000001000000001
1000100000001000000001000000001
1000000000001000000000000000001
1111111111111111111111111111111
